date, get money, correct keys, type mean, miss type, total type
2019/11/08, 2040, 628, 4.8, 50, 678
2019/11/08, 2280, 675, 4.9, 26, 701
2019/11/08, 5060, 763, 5.2, 13, 776
2019/11/08, 2280, 636, 4.7, 34, 670
2019/11/10, 2420, 706, 4.9, 39, 745
2019/11/10, 4300, 736, 5.0, 32, 768
2019/11/10, 3540, 675, 5.0, 30, 705
2019/11/11, 4300, 734, 5.1, 23, 757
2019/11/11, 4180, 731, 5.3, 32, 763
2019/11/11, 4300, 741, 5.2, 15, 756
2019/11/11, 4300, 727, 5.3, 20, 747
2019/11/11, 3800, 725, 5.1, 24, 749
